PXCrate01 Entity - (Blueprint Safe) Credits to minikinqp at CC Attribution  (Logics for importing model)
PXGenBattery Entity - (Cyber & Alien Generators) Credits to Rzyas at CC Attribution  (Logics for importing model)
CarbonGeneratorPX Entity - (Carbon Generator) Credit to curichenkow at CC Attribution  (Logics for importing model)
PXCrate02 Entity - (Construction Storage) - Credits to azzajess at CC Attribution  (Logics for importing model)
PXGalacticCrate Entity - (Tech, Mini-Fridge & Craft Storage) - Credits to Krzysztof Kauza at CC Attribution  (Logics for importing model)
PXRecycleBox Entity - (Manure Box) - Credits to SANWSH at CC Attribution (Logics for importing model)
PXRefinery Entity - (Gal Refinery) - Credits to tboiston at CC Attribution (Logics for importing model)
CarbonBatteryNew Entity - (Carbon Battery) - Credits to anastasiaremezova at CC Attribution (Logics for importing model)
PXCyberHelmet Entity - Credits to Udon-San at CC Attribution (Logics for importing model)
PXOrganFridge Entity - Credits to bossdeff at CC Attribution (Logics for importing model)
Armory Locker Entity - Credits to KonstantinaBeratze at CC Attribution (Logics for importing model)
Medkit Locker Entity - Credits to Alpha One at CC Attribution (Logics for importing model)
Tech Storage Entity - Credits to re1monsen at CC Attribution (Logics for importing model)
Freezer/Fridge Entity - Credits to re1monsen at CC Attribution (Logics for importing model)
Craft Storage Entity - Credits to re1monsen at CC Attribution (Logics for importing model)
Galactic Furnace Entity - Credits to re1monsen at CC Attribution (Logics for importing model)
Alien Pulse Rifle Entity - Credits to Bl4ckGh0st at CC Attribution (Logics for importing model)
Alien Sniper Rifle Entity - Credits to Bl4ckGh0st at CC Attribution (Logics for importing model)
Cyber Sniper Rifle Entity - Credits to Lexx at CC Attribution (Logics for importing model)
Cyber Plasma Rifle Entity - Credits to Bl4ckGh0st at CC Attribution (Logics for importing model)
Galactic Rifle Entity - Credits to lukepham-holmesglen at CC Attribution (Logics for importing model)
Galactic Pistol Entity - Credits to Adel Belloulhi at CC Attribution (Logics for importing model)
Toxic Sniper Rifle Entity - Credits to physicsvaib at CC Attribution (Logics for importing model)
Missile Launcher Entity - Credits to sobivan at CC Attribution (Logics for importing model)
Passifier Sniper Entity - Credits to Bl4ckGh0st at CC Attribution (Logics for importing model)
Cryo Freeze Rifle Entity - Credits to valerij1987 at CC Attribution (Logics for importing model)
Shock Rifle Entity - Credits to ColdSaturNight at CC Attribution (Logics for importing model)
Compound Bow Entity - Credits to Jadon_TheArtist at CC Attribution (Logics for importing model)
Dart Guns Entity - Credits to Logan Rinaldis at CC Attribution (Logics for importing model)
Alien Helmet Entity - Credits to nip88nip at CC Attribution (Logics for importing model)
Cyber Helmet Entity - Credits to SchrisArt at CC Attribution (Logics for importing model)
Galactic Helmet Entity - Credits to 打螺丝 at CC Attribution (Logics for importing model)
Blueprint Safe entity - Credits to Smoggybeard at CC Attribution (Logics for importing model)
Holo-Projector Entity - Credits to Brandon Baldwin at CC Attribution (Logics for importing model)
Holo-Projector v2 Entity - Credits to DennisGray at CC Attribution (Logics for importing model)
Crystal Tree Entity - Credits to salinaforr at CC Attribution (Logics for importing model)
Glowing Plant Entity - Credits to green364 at CC Attribution (Logics for importing model)
Frosty Mushroom Entity - Credits to Jakob_Forseth at CC Attribution (Logics for importing model)
Obelisk entity - Credits to Tink at CC Attribution (Logics for importing model)
Ring Sculpture - Credits to TomGariti at CC Attribution (Logics for importing model)
Sci-Fi Car - Credits to 3DHaupt at CC Attribution (Logics for importing model)
Eye Sculpture - Credits to OrbArts at CC Attribution (Logics for importing model)
Large Carbon Generator - Credits to  Blender3D at CC Attribution (Logics for importing model)
Alien Battery Entity - Credits to BaBuIn777 at CC Attribution (Logics for importing model)
Cyber Battery Entity - Credits to Tactical_Kredo at CC Attribution (Logics for importing model)
Galactic Siren Entity - Credits to Nomad Photo Reference at CC Attribution (Logics for importing model)
Nano-Tech Annihilator Entity - Credits to jorgedepaques at CC Attribution (Logics for importing model)
Nano-Tech Blade Entity - Credits to Ardocast at CC Attribution (Logics for importing model)
Nano-Tech Khopesh Entity - Credits to Frostoise at CC Attribution (Logics for importing model)
Nano-Tech Swarmer Entity - Credits to Darcy V at CC Attribution (Logics for importing model)
Nano-Tech Phantom Entity - Credits to Frag_Jacker at CC Attribution (Logics for importing model)
Alien/Cyber Lightning Rods - Credits to TadenStar at CC Attribution (Logics for importing model)
Alien/Cyber Sensors - Credits to JazOone at CC Attribution (Logics for importing model)
Galactic Fabricator - Credits to Shedmon at CC Attribution (Logics for importing model)
Medical Storage Large - Credits to Martin Trafas at CC Attribution (Logics for importing model)
Construction Small Storage - Credits to ul1tka at CC Attribution (Logics for importing model)
Crafting Large Storage - Credits to ul1tka at CC Attribution (Logics for importing model)
Galacticoin Safe Large - Credits to canakdemir at CC Attribution (Logics for importing model)
Blueprint Safe Large - Credits to canakdemir at CC Attribution (Logics for importing model)
Hackers Terminal - PXHackingCNS - Credits to Bogdan Kuznetsov at CC Attribution (Logics for importing model)
Trading Console - PXTradingCNS - Credits to Uğur Yakışık at CC Attribution (Logics for importing model)
Biologist Console - PXBiologistCNS - Credits to fwdhxl at CC Attribution (Logics for importing model)
Repair Station - Credits to TooManyDemons at CC Attribution (Logics for importing model)